[
  {
    "blocks": [
      "                 M                                          ",
      "                                                 M          ",
      "                                                            ",
      "                                                            ",
      "                                                            ",
      "                                         M                  ",
      "                                                            ",
      "                                                            ",
      "                                                            ",
      "              M                                             ",
      "                                                            ",
      "                                                            ",
      "                                            M               ",
      "                                                            ",
      "                                                            ",
      "                   M                                        ",
      "                                                            ",
      "                 #                                          ",
      "                 #                                          ",
      " #               #             M                            ",
      "                 #                                          ",
      "      #     ###                                             ",
      "                                                            ",
      "      -     --            -- #                              ",
      "   ####     ----         #####                              ",
      "p                                                           "
    ],
    "key": {
      "-": "test",
      "p": "player",
      "#": "static_example"
    },
    "markerKey": {
      "M": {
        "type": "platform"
      }
    }
  },
  {
    "blocks": [
      " ####                                                       ",
      "                                                            ",
      "                                                            ",
      "                                                            ",
      "                                                            ",
      "                                                            ",
      "                                                            "
    ],
    "key": {
      "#": "static_example"
    }
  }
]